+p+++++++++++++++++++++++++++++++
|                       |       +
+ +++++++++++ +++++++ + + +++++ +
| |     |   |   |   | | | |   | +
+ +++++ + + + +++ + + + + + +++ +
|       | | | |   | | | |   |   +
+ +++++++ + +++ +++ +++ + +++ + +
| |     | | |   | |   |   |   | +
+ + +++ + + + +++ +++ + +++ +++ +
| | |     | | |     | | |   |   +
+ + +++++++ + +++++ + + + +++++ +
| | |     |   |     | | |     | +
+++ + +++ +++++ +++++ +++++++ +++
|   | | |   |         |     |   +
+ +++ + +++++ +++++++++ +++ +++ +
|     |                 |       +
+++++++++++++++++++++++++++++++g+
