+p+++++++++++++++++++++++++++++++
|   |         |         |       +
+ +++ +++++ + +++ +++ +++ + +++ +
|     |     |   | | | |   |   | +
+ +++++ +++++++ + + + + +++++ + +
| |   |   |       |   | |   | | +
+ + +++++ +++++++++++ + + + + +++
| |     |       |   | | | | |   +
+ +++ +++++++++ + + +++ + + +++ +
|   |     |   | | |   |   | |   +
+++ +++ +++ + + + +++ +++++ + +++
| |   | |   |   |   | |     |   +
+ +++ + + +++++++++ + + +++++++ +
|   |   |   |     | | |   |     +
+ + +++ +++ + +++ + + +++ + +++ +
| |   | |   | | | | |     |   | +
+ + +++ + +++ + + + +++++++++ + +
| |     |   |   | | |         | +
+ +++++++++ +++ + + + +++++++++ +
|     |   |     |   | |   |   | +
+++++ + + +++++ +++++ + + + +++ +
|   | | | |   | |     | |   |   +
+ + +++ + + + +++ +++++ +++ + +++
| |     |   |     |     | | |   +
+ +++++++++++++++++ +++++ + +++ +
| |     |           |         | +
+ + +++ + +++++++ +++ +++++++++ +
| | |   |       | |     | |     +
+++ + +++++++++ + +++++ + + +++++
| | |         | | |   |   | |   +
+ + +++++++++ + + + + +++++ +++ +
|           |   |   |           +
+++++++++++++++++++++++++++++++g+
